*****************
*    a          *
*               *
*              a*
*               *
*               *
*               *
*               *
*               *
*        p      *
*               *
*               *
*               *
*               *
*               *
*               *
*               *
*               *
*               *
*               *
*               *
*               *
*               *
*   c           *
*****************
