*****************
*              a*
*               *
*               *
*               *
*               *
*               *
*               *
*               *
*               *
* a   p         *
*               *
*               *
*               *
*               *
*               *
*               *
*               *
*               *
*               *
*               *
*               *
*               *
*              c*
*****************
