*****************
*               *
*         a     *
*               *
*               *
* a             *
*               *
*               *
*          p    *
*               *
*               *
*               *
*               *
*               *
*               *
*               *
*               *
*               *
*               *
*               *
*               *
*               *
*               *
*             c *
*****************
