*****************
* a             *
*               *
*               *
*       a       *
*               *
*               *
*       p       *
*               *
*               *
*               *
*               *
*               *
*               *
*               *
*               *
*               *
*               *
*               *
*               *
*               *
*               *
*               *
*             c *
*****************
